man	man
jacket	jacket
giraffe	giraffe
sandwich	sandwich
van	van
car	car
desk	desk
zebra	zebra
child	child
woman	woman
cat	cat
truck	truck
pizza	pizza
bed	bed
bridge	bridge
horse	horse
curtain	curtain
shirt	shirt
salad	salad
dugout	dugout
motorcycle	motorcycle
bench	bench
bird	bird
bathtub	bathtub
train	train
boy	boy
airplane	airplane
dog	dog
plane	plane
cake	cake
house	house
girl	girl
robe	robe
skateboarder	skateboarder
couch	couch
lamp	lamp
cow	cow
floor	floor
donut	donut,doughnut
duck	duck
table	table
toilet	toilet
hotdog	hot dog,hotdog
pier	pier
lettuce	lettuce
dress	dress
hood	hood
seat	seat
surfer	surfer
sheep	sheep
knife	knife
skater	skater
sink	sink
counter	counter
bread	bread
skier	skier
bowl	bowl
crust	crust
mirror	mirror
building	building
carpet	carpet
batter	batter
vase	vase
poncho	poncho
ram	ram
carrot	carrot
tent	tent
dresser	dresser
boat	boat
vest	vest
tie	tie
chair	chair
tub	tub
faucet	faucet
food	food
pitcher	pitcher
blender	blender
rug	rug
hat	hat
glass	glass
cabinet	cabinet
plate	plate
streetlight	streetlight,street light
goose	goose
hydrant	fire hydrant,hydrant
marina	marina
wrap	wrap
soup	soup
bottle	bottle
mug	mug
suit	suit
apple	apple
spoon	spoon
tractor	tractor
pie	pie
fruit	fruit
cupcake	cupcake
helmet	helmet
bus	bus
pan	pan
person	person
coat	coat
mouse	mouse
jet	jet
cape	cape
flamingo	flamingo
taxi	taxi
squirrel	squirrel
couple	couple
beer	beer
toy	toy
jersey	jersey
snowboarder	snowboarder
fork	fork
cookie jar	cookie jar
baseball player	baseball player
road	road
gravy	gravy
garage	garage
balloon	balloon
sweater	sweater
pool table	pool table
hamburger	hamburger
pillow	pillow
guinea pig	guinea pig
wine	wine
burger	burger
castle	castle
cucumber	cucumber
china	china
grill	grill
umpire	umpire
umbrella	umbrella
tray	tray
swan	swan
rice	rice
catcher	catcher
croissant	croissant
airport	airport
spatula	spatula
cup	cup
pottery	pottery
fence	fence
owl	owl
shed	shed
booth	booth
parrot	parrot
pot	pot
pasta	pasta
flower	flower
bun	bun
ottoman	ottoman
statue	statue
cheese	cheese
door	door
pancakes	pancakes
face	face
goat	goat
container	container
stingray	stingray
court	court
restaurant	restaurant
flowers	flowers
llama	llama
store	store
scooter	scooter
ship	ship
oven	oven
athlete	athlete
bunk bed	bunk bed
chicken	chicken
baby	baby
wheelchair	wheelchair
wall	wall
window	window
raft	raft
biscuit	biscuit
cart	cart
dock	dock
tracks	tracks
water	water
helicopter	helicopter
refrigerator	refrigerator,fridge
jar	jar
egg	egg
tablecloth	tablecloth
wrapper	wrapper
steak	steak
plant	plant
aquarium	aquarium
cereal	cereal
kite	kite
sweatshirt	sweatshirt
hair	hair
lion	lion
player	player
bacon	bacon
firetruck	fire truck,firetruck
planter	planter
stove	stove
skateboard	skateboard,skate board
jeep	jeep
arm	arm
hut	hut
laptop	laptop
soccer player	soccer player
pen	pen
salmon	salmon
purse	purse
waffle	waffle
broccoli	broccoli
runway	runway
pancake	pancake
hamster	hamster
street	street
butterfly	butterfly
shelf	shelf
pole	pole
ostrich	ostrich
goalie	goalie
animal	animal
garage door	garage door
can	can
queen	queen
bucket	bucket
meat	meat
glove	glove
beach	beach
teddy bear	teddy bear
bookshelf	bookshelf
squash	squash
crib	crib
bagel	bagel
phone booth	phone booth
wing	wing
rooster	rooster
cookie	cookie
bull	bull
keyboard	keyboard
platform	platform
sofa	sofa
cutting board	cutting board
book	book
television	television,tv
mantle	mantle
carriage	carriage
microwave	microwave,microwave oven
tower	tower
juice	juice
bus stop	bus stop
pretzel	pretzel
turkey	turkey
tree	tree
mitten	mitten
leg	leg
mound	mound
wave	wave
hoodie	hoodie
roof	roof
lime	lime
guacamole	guacamole
turban	turban
box	box
sidewalk	sidewalk,side walk
sign	sign
grate	grate
relish	relish
lemon	lemon
toast	toast
vent	vent
hotdogs	hot dogs,hotdogs
scoreboard	scoreboard
mustard	mustard
chili	chili
fish	fish
sidecar	sidecar
toga	toga
glider	glider
sauce	sauce
elephant	elephant
apron	apron
green beans	green beans
truck bed	truck bed
pickle	pickle
dolphin	dolphin
dish	dish
hand	hand
peacock	peacock
wok	wok
canopy	canopy
glasses	glasses
curtains	curtains
trough	trough
tennis player	tennis player
snow	snow
traffic light	traffic light
blanket	blanket
shoe	shoe
quesadilla	quesadilla
bear	bear
field	field
cabinets	cabinets
bird bath	bird bath
cabbage	cabbage
dessert	dessert
taco	taco
motorcycles	motorcycles
phone	phone
ramp	ramp
light	light
gown	gown
cupcakes	cupcakes
living room	living room
bowtie	bowtie
head	head
vegetables	vegetables
toothbrush	toothbrush
game	game
suitcase	suitcase,suit case
kimono	kimono
outhouse	outhouse
dough	dough
nurse	nurse
vegetable	vegetable
puppy	puppy
shower	shower
vehicle	vehicle
hose	hose
donuts	donuts
awning	awning
eagle	eagle
banana	banana
ground	ground
coleslaw	coleslaw
propeller	propeller
rose	rose
trunk	trunk
fish tank	fish tank
moose	moose
board	board
eye mask	eye mask
clock tower	clock tower
windshield	windshield
kitten	kitten
pig	pig
melon	melon
collar	collar
kettle	kettle
remote	remote
soda	soda
device	device
kitchen	kitchen
grass	grass
wheel	wheel
legs	legs
monkey	monkey
island	island
camera	camera
bug	bug
doorway	doorway
coffee	coffee
key chain	key chain
coffee maker	coffee maker
skyline	skyline
mask	mask
patio	patio
dirt	dirt
shark	shark
trolley	trolley
display	display
measuring cup	measuring cup
wardrobe	wardrobe
urinal	urinal
storefront	storefront
clock	clock
bidet	bidet
kayak	kayak
ski lift	ski lift
vanity	vanity
furniture	furniture
bar	bar
highchair	highchair
suv	suv
stand	stand
futon	futon
parachute	parachute
tire	tire
sausage	sausage
juicer	juicer
birdbath	birdbath
muffin	muffin
teepee	teepee
church	church
rhubarb	rhubarb
drink	drink
rack	rack
surfboard	surfboard,surf board
sand	sand
teapot	teapot
sailboat	sailboat,sail boat
yogurt	yogurt
cheetah	cheetah
burrito	burrito
temple	temple
trailer	trailer
moped	moped
stroller	stroller
tortilla	tortilla
benches	benches
shelter	shelter
beard	beard
tea	tea
cinderella	cinderella
ruler	ruler
penguin	penguin
barn	barn
stump	stump
frisbee	frisbee
canister	canister
rail	rail
sail	sail
picture	picture
toaster	toaster
buffet	buffet
bricks	bricks
oatmeal	oatmeal
ambulance	ambulance
tomato	tomato
coral	coral
t-shirt	tshirt,t-shirt,t shirt
strawberry	strawberry
shore	shore
goal	goal
basketball player	basketball player
bat	bat
pool	pool
bunked	bunked
backpack	backpack
bride	bride
bike	bike
leek	leek
pants	pants
